sunny, humid, hot, cloudy, windy
drizzling = моросит
It is + adjective = A description of the weather
It is + verb-ing = This type of weather is happening now.

# cloud stuff
Bright: (adjective) full of light; when the sun is shining strongly
Sunny: (adjective) the sun is shining and there are no clouds
Clear: (adjective) without clouds
Fine: (adjective) not raining, clear sky
Partially cloudy: (adjective) when there is a mixture of both blue sky and clouds
Cloudy: (adjective) with many clouds in the sky
Overcast: (adjective) covered with cloud; dull
Gloomy: (adjective) with dark clouds and dull light; some people consider this weather depressing
Sometimes the cloud lowers to ground level and it becomes harder to see…
Fog (noun)/ foggy (adjective): thick cloud close to land
Mist (noun) / misty (adjective): light fog, often on the sea or caused by drizzle
Haze (noun) / hazy (adjective): light mist, usually caused by heat

# rain stuff
Damp: (adjective) slightly wet (often after the rain has stopped)
Drizzle: (verb/noun) to rain lightly with very fine drops
Shower: (noun) a short period of rain
Rain: (verb/noun) water that falls from the clouds in drops
Downpour: (noun) heavy rain
Pour: (verb) to have heavy rain
It's raining cats and dogs: (Idiom) To rain heavily
Flood: (verb/noun) to become covered in water usually due to excessive rain

# Cold stuff
Hail: (verb) when frozen rain falls as small balls of ice (hailstones).
Hailstones: (noun) the small hard balls of ice that fall from the sky
Snow: (noun/verb) frozen rain that falls from the sky as soft snowflakes
Snowflake: (noun) an individual piece of snow
Sleet: (noun/verb) snow or hail mixed with rain (often with some wind)
Blizzard: (noun) severe snowstorm with strong winds
freezing cold – very cold.
icy – covered in ice; slippery because of ice
hard frost – when it gets very cold overnight and everything is covered with thick frost.
chilly – uncomfortably cold.


# Types of Wind
Breeze: a gentle wind (often nice or refreshing)
Blustery: blowing (strong) gusts of wind
Windy: continual wind.
Gale: a very strong wind
Hurricane/cyclone/typhoon: a spiral arrangement of thunderstorms that produce winds and heavy rain.
wind chill (factor) – when the wind makes the air feel colder than the actual temperature.

# Snow
keep a close eye on the weather forecast
fresh snow – snow that has recently fallen
heavy snow – when a lot of snow falls
snowstorm – when a large amount of snow falls, often mixed with wind
flurry – very light snowfall
hail – pieces of ice falling from the sky; frozen rain.


mild climate/weather/winter
flooding
sun comes out
a cloud in the sky
