# Interview: from http://kuzina.me/unit-1-tell/

-------------------------
Tell me about yourself

Q: Tell me about yourself
professional expertise = профессиональный опыт
a bachelor degree/ master degree = степень бакалавра/ магистра
strong communication skills = развитые коммуникативные навыки
to be used to working unsupervised = привыкнуть работать самостоятельно
to come up with a solution = придумать решение
qualified for the position = квалифицирован для должности
tenacious in achieving goals = настойчив в достижении целей
the next step in my career = следующий карьерный шаг
to communicate with the team = общаться с коллективом
an excellent opportunity = отличная возможность
my greatest achievement = моё главное достижение
to implement a task = осуществлять задачу

-------------------------
What are your main strengths?

Q: What are your main strengths?
to be good at multitasking = хорошо справляться с множеством задач
to work under pressure = работать под давлением
a problem solver = сотрудник, умеющий решать проблемы
to explain complicated topics = объяснять сложные темы
to prioritise tasks = расставлять приоритеты в задачах
to overcome the obstacles = преодолевать препятствия
urgent and important tasks = срочные и важные задачи
to excel in work = отлично исполнять работу
to meet deadlines = делать работу в срок
a resourceful person = находчивый человек
time management skills = навыки управления временем
to interact with my colleagues = взаимодействовать с коллегами

-------------------------
What are your greatest weaknesses?

Q: What are your greatest weaknesses?
to delegate tasks = делегировать задачи
to feel irritated = ощущать раздражение
to value opinion = ценить мнение
an efficient approach = эффективный подход
to feel responsible = ощущать ответственность
time-eaters  = поглотители времени
to make decisions fast = быстро принимать решения
a procrastinating colleague  = коллега, тянущий время
productive = продуктивный
brainstorming sessions = мозговые штурмы
to regain focus = восстановить концентрацию
to learn from mistakes = учиться на ошибках


-------------------------
Why do you want to leave your current job?

Q: Why do you want to leave your current job?
to be looking for challenge = искать более сложные задачи
to resign = уволиться
to be satisfied with the job = быть довольным работой
professional development = профессиональное развитие
daily commute = ежедневная езда на работу
familiar tasks = знакомые задачи
to reach the top = достичь вершины
to work closer to home = работать ближе к дому
increased responsibility = повышенная ответственность
remuneration = компенсация (оплата труда)
more responsibilities = больше обязанностей
career advancement = карьерный рост


-------------------------
Why should we hire you?

Q: Why should we hire you?
to deliver results = добиваться результатов
to get out of comfort zone = выбраться из зоны комфорта
the right person = подходящий человек
a win-win solution  (see below) = решение выигрыш-выигрыш
a result-oriented person = человек, ориентированный на результат
suitable qualifications and work experience = подходящая квалификация и опыт работы
to value relationships = ценить отношения
continuous improvement = постоянное улучшение
a partnership approach = партнерский подход
to look for skills and experience = искать навыки и опыт
to be confident = быть уверенным
to handle a difficult task = справляться со сложной задачей


-------------------------
What did you do when you failed to accomplish an important task? What lessons did you learn?

Q: What did you do when you failed to accomplish an important task? What lessons did you learn?
to keep myself organised = быть организованным
peace of mind  = спокойствие ума
a damage to reputation = вред репутации
to turn failure into opportunity = превратить неудачу в возможность
daily plan = ежедневный план
a punctual person = пунктуальный человек
to miss a deadline = не соблюсти сроки
to analyse the reasons = проанализировать причины
to avoid similar situations = избегать подобных ситуаций
apologise = извиниться
to feel speechless = потерять дар речи
to come on time = приходить вовремя


-------------------------
What are you looking for in your next job?

Q: What are you looking for in your next job?
remuneration package = компенсационный пакет (зарплата)
development opportunities = возможности для развития
to be significant  = быть значимым
intellectually stimulating job = интеллектуально стимулирующая работа
adequate reward = соответствующее вознаграждение
atmosphere of trust = атмосфера доверия
to share values = разделять ценности
important criteria = важные критерии
to be ready to contribute = быть готовым внести свой вклад
to feel respect = ощущать уважение
corporate culture = корпоративная культура
a challenging job = сложная работа


-------------------------
What did you most dislike about your last employer?

Q: What did you most dislike about your last employer?
to develop work skills = развить рабочие навыки
a great match for my skill set = подходящая должность для моих навыков
inspiring projects = вдохновляющие проекты
to know the ropes = знать все “входы и выходы”, разбираться (идиома)
business processes = бизнес-процессы
to demotivate = демотивировать
to reach full potential = раскрыть полный потенциал
to utilise skill set = использовать набор навыков
work atmosphere = рабочая атмосфера
to feel challenged enough = ощущать достаточный вызов
to be good at communication = хорошо проявлять себя в общении
to provide growth opportunities = предоставлять возможности роста


-------------------------
What is your typical working week in hours? Can you describe it?

Q: What is your typical working week in hours? Can you describe it?
to stay longer = оставаться дольше
poor management = плохое управление
work-life balance = баланс работа-жизнь
to schedule meetings = назначать встречи
to get my job done = чтобы моя работа была сделана
to prioritise activities = расставлять приоритеты в работе
urgent tasks = срочные задачи
occasional overwork = случающиеся время от времени переработки
to rearrange tasks = перераспределить задачи
to work extra hours = работать cверхурочно
to lead to burnout (see below) = приводить к выгоранию
that’s more of an exception = это скорее исключение


-------------------------
What lessons have you learned from your past career?

Q: What lessons have you learned from your past career?
to do work on your own = работать самостоятельно
to own up to mistakes = признавать ошибки
to acknowledge your mistake = признать вашу ошибку
to achieve targets = достигать цели
to deny your fault = отрицать вину
to ask clarifying questions = задавать уточняющие вопросы
to fix mistakes = исправить ошибку
team player = член команды
more productive = более продуктивно
a piece of advice = совет
a difficult assignment = сложное задание
the support of teammates = поддержка коллег


-------------------------
What would you most like NOT to do in this role?

Q: What would you most like NOT to do in this role?
red tape = бюрократия (идиома)
tight deadlines = жёсткие крайние сроки
to delay decisions = отсрочить решения
hard effort = тяжёлые усилия
creative tasks = творческие задачи
to finish the task on time = окончить задачу вовремя
to perform duties = исполнять обязанности
a contingency plan = план на случай непредвиденных обстоятельств
to go on a sick leave = уйти на больничный
familiar responsibilities = знакомые обязанности
to repair a computer = чинить компьютер
routine tasks = рутинные задачи



-------------------------
What would your job references say about you?

Q: What would your job references say about you?
to show recognition = показывать признание
to prevent problems = предотвращать проблемы
positive impact = положительное влияние
to show initiative = проявлять инициативу
to adopt measures = принять меры
performance evaluation = оценка производительности труда
problem-solving skills = навыки решения проблем
to set tasks = ставить задачи
to anticipate issues = предвидеть проблемы
to suggest measures = предлагать меры
evident solutions = очевидные решения
positive attitude = позитивное отношение


-------------------------
Tell us about a time when you have had to manage conflict at work. How did you do it?

Q: Tell us about a time when you have had to manage conflict at work. How did you do it?
to calm down = успокоиться
to complete the project successfully = успешно завершить проект
accounting department = бухгалтерия
to persuade a person = убедить человека
the failure to pay on time = несвоевременная оплата
inevitable conflicts = неизбежные конфликты
to investigate the reasons = расследовать причины
to give a larger perspective = показать более крупную перспективу
important duties = важные обязанности
different interests = различающиеся интересы
financial trouble = финансовые трудности
to indicate explicitly = явственно указать


-------------------------
How do you manage stress in your daily work?

Q: How do you manage stress in your daily work?
to stay motivated = оставаться мотивированным
tight deadline = жёстко ограниченные сроки
to feel overwhelmed = ощущать себя перегруженным
positive stress = положительный стресс
to contribute to stress = способствовать стрессу
gym workout = тренировка в спортзале
to get enough sleep = выспаться
mentally and physically defeating = умственно и физически истощающий
dynamic environment = динамичная среда
to reduce the amount of stress = снизить количество стресса
to work productively = работать продуктивно
to manage time = управлять временем

-------------------------
What are your job related goals for the next years?

Q: What are your job related goals for the next years?
to become proficient in = стать профессионалом в
networking events = события по обмену опытом
career perspective = перспектива карьеры
to observe best practices = наблюдать за лучшими приёмами
to take steps each day = делать шаги каждый день
to exchange ideas = обмениваться идеями
to find a new job = найти новую работу
to develop public speaking skills = развить навыки публичных выступлений
to learn company policies = изучить политики компании
to share my expertise = поделиться своим профессиональным опытом
to attend seminars = посещать семинары
to focus my efforts on integration = сфокусировать свои идеи на интеграции

-------------------------
Can you describe a situation in your experience when you were able to solve a problem for your employer?

Q: Can you describe a situation in your experience when you were able to solve a problem for your employer?
price estimate = ценовая смета
to agree to terms = согласиться с условиями
to estimate the potential time = оценить потенциальное время
to keep partnership = сохранить партнёрство
delivery terms = условия доставки
a 15% economy = 15% экономия
to reduce the costs = уменьшить затраты
to explain options = объяснить варианты выбора
to do a market research = провести рыночное исследование
a favourable price = благоприятная цена
a local supplier = местный поставщик
to negotiate the price = договориться о цене


-------------------------
How would you motivate your colleagues to do some task that they don’t want to do?

Q: How would you motivate your colleagues to do some task that they don’t want to do?
to work extra = работать сверхурочно
to show recognition = показывать признание
to look forward to holidays = предвкушать праздники
to work productively = продуктивно работать
a praise at a meeting = похвала на встрече
to have a clear perspective = обладать ясным видением
to do the task successfully = успешно выполнить задачу
to feel reluctant = ощущать нежелание
positive evaluation = позитивная оценка
the best choice for the job = лучший выбор для работы
to identify potential benefits = определить потенциальные преимущества
to offer assistance = предоставить помощь


-------------------------
What are you doing today to accomplish your future goals?

Q: What are you doing today to accomplish your future goals?
a valuable employee = ценный сотрудник
to keep abreast of  = быть в курсе (идиома)
to show achievements = показывать достижения
to develop skills = развивать навыки
to feel the atmosphere = ощутить атмосферу
to gain financial stability = достичь финансовой стабильности
to educate myself = заниматься самообразованием
experience and strengths = опыт и сильные стороны
to communicate with potential employers = общаться с потенциальными работодателями
to attend professional seminars = посещать профессиональные семинары
a reputable company = компания с хорошей репутацией
personal development = личностный рост



-------------------------
Can you provide an example of how you have acted as a team player?

Q: Can you provide an example of how you have acted as a team player?
to take into consideration goals = принимать во внимание цели
to find the best solution = найти наилучшее решение
to contribute ideas = предлагать идеи
to get the job done = завершить работу
to discuss issues = обсуждать идеи
to make the day productive = сделать день продуктивным
ambition = амбиции
to help coworkers = помогать сотрудникам
to communicate with team members = общаться с членами команды
to volunteer to do work = вызваться сделать работу
to spoil the relationship = испортить отношения
respect for each other’s opinion = уважение к мнению друг друга



-------------------------
How can a leader inspire a team?

Q: How can a leader inspire a team?
to communicate with clarity = общаться доходчиво
to develop meaningful relationships  = развивать значимые отношения
to talk on a regular basis = регулярно общаться
to ensure commitment = обеспечить заинтересованность
to make employees feel recognised = признать заслуги сотрудников
to present clear goals = ставить ясные цели
to share optimism = передавать оптимизм
to maintain open communication = поддерживать открытое общение
to transfer vision = передавать видение
an active role in project = активная роль в процессе
clear steps to achieve goals = чёткие шаги для достижения цели
a charismatic personality = харизматичная личность

